




TxStatus  ERROR List:

    TxStatusSuccess            = 0,    		ERROR 0		< Success 
    TxStatusAckFail            = 1,    		ERROR 1		< MAC ACK Failure 
    TxStatusCCAFail            = 2,     	ERROR 2		< CCA Failure 
    TxStatusInvDestEP          = 0x15,  	ERROR 21	< Invalid destination endpoint 
    TxStatusNwAckFail          = 0x21,  	ERROR 33	< Network ACK Failure 
    TxStatusNotJoinNw          = 0x22,  	ERROR 34	< Not Joined to Network 
    TxStatusSelfAddr           = 0x23,  	ERROR 35	< Self-addressed 
    TxStatusAddrNotFound       = 0x24,  	ERROR 36	< Address Not Found 
    TxStatusRouteNotFound      = 0x25,  	ERROR 37	< Route Not Found 
    TxStatusBroadSrcFail2Heard = 0x26, 		ERROR 38	< Broadcast source failed to hear a neighbor relay the message 
    TxStatusInvBindTableIdx    = 0x2B,  	ERROR 43	< Invalid binding table index 
    TxStatusResourceError      = 0x2C,  	ERROR 44	< Resource error lack of free buffers, timers, etc. 
    TxStatusAttBroadcWithAPS   = 0x2D,  	ERROR 45	< Attempted broadcast with APS transmission 
    TxStatusAttUnicWithAPSEE0  = 0x2E,  	ERROR 46	< Attempted unicast with APS transmission, but EE=0 
    TxStatusResourceError2     = 0x31,  	ERROR 49	< TxStatusResourceError2 
    TxStatusInternalError      = 0x32,  	ERROR 50	< Resource error lack of free buffers, timers, etc. 
    TxStatusPayloadTooLarge    = 0x74,  	ERROR 116	< Data payload too large 
    TxStatusIndirectMsgUnReq   = 0x75,  	ERROR 117	< Indirect message unrequested 
    TxStatusInvalidAddr        = 0xfe,  	ERROR 254	< Invalid Address (Error generated by the library) 
    TxStatusTimeout            = 0xff,  	ERROR 255	< Timeout (Error generated by the library) 